1111111111111111
1200002112000021
1000000110000001
1000000000000001
1300000000000041
1000000000000001
1000000110000001
1200002112000021
1111111111111111
