111111111111111111
120030021120000021
100000001100000001
100000000000000001
100001002200010041
100000000000000001
100000001100000001
120030021120000021
111111111111111111