111111111111111111
120030041120000021
100000000000000001
100000000000000201
100000000000220241
100000000000000001
100000000000000001
120000021120000021
111111111111111111