111111111111111111
120030021120000021
100000001100000001
100000000000020001
100000000000222241
100000000000000001
100000000000000001
120000021120000021
111111111111111111